111111111
1P01C0001
110101101
10C0000E1
111111111