111111111
1P01C0001
110101101
1000000E1
111111111