1111111111
10P0100001
100000C001
1000001001
100001C001
10000000E1
1111111111