1111111111111111
1P00001C001C0001
1011011110101101
1010001000001001
10000000111110E1
1001001000000001
1011101110110101
100C100C100C0101
1111111111111111