11111111111111111111111
100001C0000000000000011
10000111111111111C00001
10P000001000000011100E1
10000100101111100010111
100001C0000X0000000C001
11111111111111111111111