11111111111111111111111111111111111111111
10000100000000000000000000000000000000001
10000100000000000000000000000000000000001
10000100000000000000000000000000000000001
10000100000000000000000000000000000000001
10000100000000000000000000000000000000001
10000100000000000000000000000000000000001
10000100000000000000000000000000000000001
10000111111111000000000000000000000000001
10000000000000000000000000000000000000001
100P00000000000000000000000000000000000E1
10000000000000000000000000000000000000001
10000111111111000000000000000000000000001
100001000000C1000000000000000000000000001
10000101111111000000000000000000000000001
10000101C00000011111110000000000000000001
10000101110000010000100000000000000000001
10000100000000010110100000000000000000001
10000111111111110110111110000000000000001
100001C0000000000000000000000000000000001
11111111111111111111111111111111111111111